 _______ _______ _______      _____   _______ _______ _______ (TM)
|_     _|   |   |    ___|    |     |_|_     _|     __|_     _|
  |   | |       |    ___|    |       |_|   |_|__     | |   |
  |___| |___|___|_______|    |_______|_______|_______| |___|
pieces of media:		149
character count:		802

~△☾☼☣⊗

△: cloaked
☾: dark silhouette
☼: light silhouette
☣: hazmat suit
⊗: old dive suit

* .flow				the gasmask effect ~☣ / the psychedelic effect ☾
* a hat in time			badge seller △ / birds ~☾ / c.a.w agents △ / dwellers ~☾ / rough patches ~☾ / nomads △☾ / shadow puppet ☾ / snatcher ☾ / snatcher's minions ☾ / transcendent costume ☾ / queen vanessa ☾
* abzû				diver ~☾
* andromedia 			beltrowel ~△ / friend △☾ / gggggg △ / gospiel ~△ / minerva △ / pionite △☾ / the acolyte △ / the angel ☾
* animal crossing		jack △
* answered prayers		aby the phantom ☾ / fluorette ~△ / her ☾ / the phantom prayer ☾
* apex legends			ash ~△ / bloodhound ~△~☣ / caustic ~☣ / revenant ~△
* assassin's creed		assassins △
* bad end theater		the director ☾ / tragedy △☾
* barony			baron herx ~△~☾ / erudyce △☾ / shadow ☾
* bioshock			big daddies ⊗
* blazblue			arakune ~☾ / kaka ~△~☾ / spirit body terumi ☾
* bloodborne			hunter △
* bloons			apex plasma master ~△ / arcane spike △ / archmage △ / ascended shadow △ / ball lightning ~△ / bloonjitsu △ / bloon dissolver ☣ / bloon liquefier ☣ / book wyrm ~△ / corrosive glue ~☣
				/ crossbow master △ / dark champion △ / dark knight △ / double shot △ / druid of the storm ~△ / giganotosaurus ~△ / glaive dominus △ / glue hose ☣ / glue splatter ~☣ / glue storm ☣ / glue strike ☣
				/ grandmaster ninja △ / glaive lord ~△ / legend of the night ~△ / m.o.a.r. glaives ~△ / megalodon ⊗ / moab glue  ☣ / necromancer: unpopped army △ / pouākai ~△ / prince of darkness △
				/ relentless glue ☣ / shimmer ~△ / stronger glue ~☣ / superstorm ~△ / super glue ☣ / the bloon solver ☣ / voidora ☾, ☼ / wizard lord phoenix ~△
* breath of fire		loki △
* brutal orchestra		bosch ☾ / burnout ☾ / nowak ~△~☾
* bug fables			the watcher △
* cave story			puu black ~☾
* celeste			dust bunnies ☾
* chants of sennaar		the protagonist △
* chapter rewritten		nito ~△ / charkis (ch1) ~△☾
* control			astral spike ☾
* corru.observer		geli ☾ / moth ☾
* crypt of the necrodancer	reaper △ / warlocks △
* cuphead			mortimer freeze ~△
* cult of the lamb		aym ~△ / baal ~△ / chemach △☾ / clauneck △☾ / darkwood enemies ~☾ / enemy cultists △~☾ / forneus ☾ / haro △☾ / heket: bishop of famine ~△ / kallamar: bishop of pestilence ~△ / kudaai △☾
				/ leshy: bishop of chaos ~△ / lighthouse follower △ / lighthouse keeper ~△ / monch ~△ / mystic seller △☾ / red crown ☾ / shamura: bishop of knowledge and war ~△ / shrumy ~△ / the executioner ~△
				/ the fox ~△ / the lamb ~△ / the one who waits ~△
* dark cloud			moon people △☾ / the darkness ~☾
* darkest dungeon		antiquarian ~△ / brigand raider ~△ / cultist priest △ / jester ~△ / necromancer △ / pillager crackshot ~△ / plague doctor △ / scarecrow △ / the collector △
* dead cells			the beheaded ~△ / the blacksmith ~△ / the collector △ / the collector's intern △ / the fisherman ~△ / the scribe ~△ / the scarecrow △
* dead estate			ashleys ~☾ / cult bishops △ / cult necromancer △ / hazmats ☣ / healer ~△☣ / lost wanderers ~△ / masked cultists △ / robed cultists ~△ / stalkers ☾ / the glitch ☾☼ / wizards △
* deemo				deemo ☾
* deep dreams			phantom woman ☾
* deltarune			ralsei (ch1) △☾ / seam ~△ / shadowmen ☾ / the titans ☾
* death's door			death △~☾
* dicey dungeons		copycat △ / cornelius ☾ / warlock △
* don't starve			ancient herald ~△☾ / beardlings ~☾ / beardlords ~☾ / charlie's carrats ☾ / crawling horrors ☾ / fused shadelings ☾ / gestalts ☼ / jitters ☾ / mr. skittish ☾ / mr. skitts ☾ / masked pig △
				/ night hands ☾ / parasitic shadelings ☾ / pipspooks ☼ / rasp ~☾ / resting horror ☾ / shadow peices ☾ / shadow puppets ☾ / shadow splumonkeys ☾ / shadow tentacles ☾ / shadow watcher ☾ / shriek △☾
				/ slurpers ~☾ / spiders ~☾ / spitters ~☾ / swimming horror ☾ / terrorbeaks ☾ / terrorclaws ☾ / totally normal bats ☾ / webber ~☾ / wavery jones ☾
* dream genie			big monster ~△ / evil spirit ☾ / ren's △
* dredge			hooded figures △
* ǝna				brick frog ~☾ / children ☾ / merchant ☾ / shadow people ☾ / volley △
* enter the gungeon		confirmed △ / gunjurer △ / gunreaper △☾ / high priest △ / lich △ / lord of the jammed △☾ / shadow magician ☾△ / the cultist △ / the gunslinger △
* epithet erased		moot △, ☾ / zora ~△
* everhood			brown mage △ / cat god ☾ / buddha ☾ / green mage △ / higher beings ~☼ / light being ☼ / masterpiece ☾ / maze monster ☾ / pink ☼ / purple mage △ / red △ / white skeleton ☾
* excelsior			new year △
* final fantasy			black mages △
* five nights at freddy's	dark freddy ☾ / highscore chica ☾ / nightmare ☾ / nightmarionne ☾ / party freddy ☾ / phantom ballon boy ~☾ / phantom chica ~☾ / phantom foxy ~☾ / phantom freddy ~☾ / phantom mangle ~☾ / phanton puppet ☾
				/ rwqfsfasxc ☾	/ shadow ballon boy ☾ / shadow cupcake ☾ / shadow freddy ☾ / shadow mangle ☾ / shadow puppet ☾ / system error toy bonnie ☼ / the entity ~☾ / vr toy freddy ☾
* fortnite			cloaked shadow △ / cloaked star △ / deadeye ☾ / drift ~△ / flow ☾ / fusion ~△~☾ / galaxy ☾ / grimey ~△☾ / hades △ / hedron ☾ / infinity ~△☾☼ / iso ☾ / kondor △ / lumi jellie △☼ / neuralynx △
				/ omen ~△ / phanton meowcles △ / perfect shadow △☾ / plague △ / pulse ☾ / raven △ / raven team leader △☾ / sayara ~△ / scourge △ / swamp knight △ / the ice king △~☾ / wrath △ / zero ☼
* game and watch		mr. game and watch ☾
* genshin impact		fatui △ / kabukimono ~△ / seelie ☼
* geometry dash			the cursed thorn ☾
* ghostrunner			ghostrunner ~△
* gravity falls			hide behind ☾ / summerween trickster ~△~☾
* grimm's hollow		baker △ / grimm △
* guilty gear			that man △
* hades				charon △ / hecate △ / npcs in the house of hades △
* have a nice death		brad ~☾ / death △ / dustins ~☾ / ghosts ☼ / horace sinistrocirrus ☾ / magmaboy-x4s ☾☼ / maxxx ~☾ / mr. gordon grimes ~☾ / sparkies ☼ / stormies ☾ / the "bridgets" △
* hazbin hotel			tom trench ☣ /  valentino ~△ / zestial △~☾
* hollow knight			cloth ~△ / confessor jiji △ / elderbug △ / grimm △ / hollow knight ~△☾ / hornet △ / lightseeds ~☼ / lifeseeds ~☼ / lurien △ / mask maker ~△☾ / nailmasters △ / pale king △ / pure vessel ~△☾
				/ radience ☼ / seer ~△ / shade ☾ / siblings ☾ / snail shamans ☾ / the collector ☾ / the hunter ~△☾ / the knight △
* hyperdimension neptunia	mine △, ☾
* hyper light drifter		judgement ☾ / the archer △ / the drifter △ / the hierophant △ / the reaper △ / vulture shaman △
* inscryption			cards ☾ / the lonely wizard ~△☾
* in stars and time		loop ☾☼ / sadnesses (overworld) ☾ / siffrin △
* it steals			phantom ☾
* journey			ancestors △ / wayfarers △
* jojo's bizarre adventure	chariot requiem ~△☾ / remote romance △ / sethan ☾ / wonder of u ~△
* kingdom hearts		diz △ / foretellers △ / heartless ☾ / master of masters △ / organization xiii △ / the phantom △ / the unversed ~☾ / vanitas ~△
* kirby				bio spark ~△~☾ / chemitory ~☾ / dark matter ~☾ / dark matter blade ~△ / dark nebula ☾ / daroach △ / degout ☾ / doomers ☾, ☼ / drawcia △ / efreeti ☾ / flamberge △ / francisca △ / geg ~☾ / gruegloom ☾
				/ hurly ☾ / hyness ~△ / jambeliever ~△~☾ / jammerjab ~△~☾ / king d-mind core ☾ / klinko ~△~☾ / koozer ~☾ / madoo △☾ / magolor △ / magoo ☾ / mariel ☾ / mumbies △☾ / nesp △ / nidoo ☾ / nightmare △
				/ paintra △ / punc ☾ / ringle ☾ / shadow bite ☾ / shadow dedede ☾ / shadow kirby ☾ / simirror △ / spynum △ / squashini ~△ / togezo ☾ / vividria ~△ / void ☼ / waiu △ / wester △☾ / yin-yarn ~△
				/ zan partizanne △
* klonoa			ghadius △ / noctis sol ~☾
* lethal company		employees ☣
* library of ruina		alloc △ / alpha △ / arnold △ / bamboo hatted kim △ / beta △ / bono ~△ / consta △ / dalloc △ / gamma △ / jin △ / mo △ / naoki ~△ / oscar △ / sweepers ☣ / tenma ~△ / the black silence ~△
				/ wang ~△
* limbo				humans ☾ / the spider ☾
* limbus company		dante ~△ / distorted bamboo-hatted kim △ / dongbaek ~△ / dongrang distortion ~△ / hook office fixer hong lu △ / hooligans ~△ / k corp. security ~△ / k corp. class 3 excision staff hong lu ~△
				/ marile △
* little nightmares		dark six ☾ / glitching remains ☾ / masked remains ☾ / mono ~△ / six ~△ / the lady ~△ / the thin man ~△
* lobotomy corporation		big bird ~☾ / clouded monk △ / der freischütz ~△☾ / funeral of the dead butterflies ☾ / judgement bird ~☾ / la luna △ / little red riding hooded mercenary △☾ / plague doctor △ / the snow queen △
* lsd dream emulator		gray man △ / gunman △
* mario				charold △ / cosmic clones ☾ / count bleck △ / dimentio ~△ / fawful △, ☾ / fury bowser ☾ / fuzzies ☾ / geno ~△ / hell valley sky trees ☾ / merluvlee △ / monstar ☾ / ninji ~△~☾ / ravens ~☾ / shadoo ☾
				/ shadow mario ~☾ / shadow sirens ~△☾ / shadow queen ☾ / smorgs ☾ / twilighters ~△~☾
* marvel			spider-man noir △ / upgraded spot ☾
* megami tensei			black rider △ / erebus ☾ / pale rider △ / red rider △ / shadows (overworld) ~☾ / the black mask ~△~☾ / the reaper △ / white rider △
* milk series			voice ☾
* minecraft			ender dragon ☾ / endermen ☾ / endermites ☾
* mob psycho			??? ☾
* monster prom			moss mann ~△ / oz ☾
* monument valley		crow people ☾ / princess ida ☼ / ro △~☾ / ro's child ~△☾ / the storyteller ~△~☼
* murder drones			humans ☣, ☾
* nier				companions △ / fyra △ / kalil ☾ / king's advisor △ / priyet △
* noita				alkemisti △ / houre ☾ / kalmamato ~☾ / kiukkukalma ☾ / kummitus ☾ / mages △ / minä △ / olemanton ☾ / spiraalikalma ☾ / varjokkupla ☾ / ylialkemisti △
* nuclear throne		assassins △ / bandits △ / guardians ☼ / horror ☼ / lil' hunter ☣ / necromancers △, ~△☼ / ravens △~☾ / rebel △ / snipers ~△
* omori				abbi ☾ / big pocket ~☾ / daddy longlegs ☾ / facelesses ~☾ / ghost bunnies ~☾ / mewo ~☾ / keeper of the castle ☾ / somethings ~☾ / spider cat ~☾ / stranger ~☾ / uni ☾
* oneshot			niko △
* over the garden wall		the beast △☾
* overwatch			ana ~△ / ramattra ~△ / reaper △
* paper lily			little kat ☾ / miss knives ~△ / primal demons ☾ / rune △~☾ / spider ~☾ / the prisoner ☾
* papers please			ezic messenger ~△
* pikmin			ice pikmin ☼ / shaggy long legs ~☾ / smoky progg ~☾
* pokemon			cosmeom ~☾ / cosmog ~☾ / darkrai △☾ / decidueyes ~△ / ghastlies ~☾ / lunala ~☾ / masked man △ / mimikyus △☾ / miniors (core) ☼ / mismagiuses ~△ / necrozma ☾, ☾☼, ☼ / snorunts ~△~☾ / unowns ☾
				/ yamasks ☾ / zekrom  ☾
* princess remedy		princess remedy ~△
* puyo puyo			ecolo ☾ / lemres ~△ / rei △ / will-o-wisp ☼ / wraith ~△~☾ / yu △ / zero ~△
* rain world			rain deer ☾
* resident evil			merchant △
* revita			acceptance ☾ / beyeshops △ / culteyes △ / enigma △ / executinors ~△ / gear dancers ~△ / inquisitors ~△ / leyechs △ / shroomancers △ / the imprisoned ~☾
* risk of rain			bandit ~△ / clay man ~☾ / goobo jr. ☾ / imps ☾ / providence △ / scavenger ~☾ / v??oid fiend ☾ / wisps ☾☼
* rivals of aether		clairen △ / mollo △
* scp				049-1 △~☣ / 106 ~☾ / chaos insurgency ~☣ / mtf beta-7 "maz hatters" ☣
* shadow of the colossus	dormin ☾
* shovel knight			blubber meanies △ / hover meanies △ / liquid samurias △☾ / macawbes ☾ / plague knight △~☣ / plague minions △~☣ / spectre knight ~△ / treasure knight ⊗
* skul: the hero slayer		abyssal monarch △~☾ / black lab chief ☣ / collector △ / frozen soul ☼ / gambler △ / great warlock △ / grim reaper △ / ninja master ~△ / outlaw △ / sage △ / samurai ~△ / saviour △~☾ / sniper △
				/ voodoo test subject ~△
* skullgirls			bigband △~☣ / black dahlia ~△ / skull heart ☾
* sky: children of the light	abyss monster ☾ / ancestors ~△~☼ / butterflies ☼ / dark dragons ☾ / dark shadows ☾ / jellyfish ~☼ / nine-colored deer ~☼ / sky children △~☼
* slime rancher			bob ~△ / glitch slimes ~☾ / the tarr ☾
* slay the spire		chosens △ / darklings ☾ / gremlin leader △ / mystics △ / nemeses △ / slavers ~△ / silent △ / taskmasters △ / the collector △ / transients ☾
* solar ash			cyd △ / echo ☼ / rei ~△
* sonic				big mothers ☾ / dark bats ☾ / dark eel ☾ / dark gaia masters △☾ / frights ☾ / killer bees ☾ / nightmares ☾ / rexes ☾ / spikes ☾ / titans ☾
* spark the electric jester	romalo △ / the beast ☾ / the ghost ☾ / the puppet ☾ / the reaper △☾
* splatoon			flippeer-flopper ~☣ / jelletons ~☾ / order ☾
* spooky's jump scare mansion	class shadows ☾ / frenzy ☾ / howard ~☾ / monster 2 △ / scare chair ☾ / specimen 2 ~☾ / specimen 8 △ / the protagonist ☾ / unknown specimen 3 △ / wolfgang amadeus mozart ~☾
* spirited away			no-face ☾
* star wars			darth sidious ~△ / jawa △☾ / tusken raiders △
* stardew valley		krobus ☾, △☾
* steven universe		white diamond ☼
* sucker for love		muu ~△~☾ / nyanlathotep ~△
* subnautica			ghost leviathans ~☼
* subspace emissary		ancient minister △ / floows ~☾ / poppants ~☾ / shaydas ☾ / tabuu ☼
* terminal 00			the first arcent △
* terraria & terraria calamity	cultists △ / lunatic cultist △ / reaper △ / signus △~☾ / supreme witch calamitas △ / wraiths △
* the amazing digital circus	abstractions ☾
* the backrooms			async employees ☣ / bacteria ~☾
* the binding of issac		cultists △ / dogma ☾☼ / my shadows ☾ / scourge ~△ / shadow judas ☾ / shadies ☾ / the deciever ☾ / the fettered △
* the end is nigh		ash ☾ / the friend ☾
* the girl from the other side	teacher ~△~☾
* the legend of zelda		blupees ~☼ / boes ☾ / calamity ganon ~☾ / chuchus ☼ / dark link ☾ / fairies ☼ / ganondorf dragmire ~△ / garo robes △~☾ / ghoul rats ~☼ / gibdos ~△~☾ / gomess △☾ / light spirits ☼
				/ lord of the mountain ☼ / malice ☾ / midna (true form) △ / old man △ / phantom ganon ☾ / poes △ / poe collector △~☾ / rosa △ / shadow links ☾ / sheik △ / skull kids △ , ~△☾ / wizzrobes △
				/ yiga ~△ / zant △☾
* the sims			the grim reaper△
* the upturned			chompers ☾ / crows ~☾ / giant hands ☾ / ik ☾ / lil' chucklers ☾ / mr.sob ☾ / ribcage ~☾ / shrimp ☾ / the mother slug ☾ / the protagonist △☾ / the water slugs ☾
* the void rains upon her heart	veyerals ☾
* time fcuk			stevens ☾
* tower of heaven		eid ~☾
* ultrakill			corpse of king minos ~☾ / earthmovers ~☾ / ferrymen △ / guttermen ⊗ / minos prime ☼ / puppets ☾ / sisyphus prime ☼ / stalkers △ / the council △
* undertale			river person △
* underworld office		boss ☾ / charlie ☾ / river ☾
* uneven dream			dudes ☾ / puppeteers ~△ / the dark matter effect ☾ / the seer effect △
* vagante			mages △ / necromancer △ / shadow knight △
* valorant			cypher △ / omen ~△
* vampire survivors		atlantean △ / avatar of gaea ☼ / boon marrabbio ☾ / death △ / hag ~△ / maronna ~△ / mask of the red death △ / reaper trainee △ / rose de infernas ☾ / the directer ☾
* vocaloid			neumaf △☾ / wowmaf △☾
* voices of the void		fast shadow figure △☾ / jellyfish ☼ / nuclear argemia plushies ☼ / the eyes ~☾ / the fridge ~☾ / the hanged man ☾ / wisps ☼
* warhammer 40000		tech-priests △~☣
* xeno				wiseman △
* yume nikki			alley demon ~☾ / pissipissini ☾ / the neon effect ☾ / the towel effect △ / yuki-onna ~△
* yume 2kki			biker uro ☾ / boy outline ~☾ / black hole girls ☾ / guardians ☾ / novaflow ~△ / punis ~☾ / shadow chasers ☾ / shadow ninetails ☾ / sprite ☼ / the invisible effect ☾ / the teru teru bōzu effect △
* zardy's maze			brutes △ / cable crows ~△ / pumpkin jacks ~△ / zahrada ~△ / ??? △
* ███							k. △, ☾